##@---A---+
##########|
##x-B-+###C
######|###|
######+---+