@#----A---+
##########|
##x-B-+###C
######|###|
######+---+