@-+#####
##|#####
##A#####
##+-B-+#
######|#
######C#
######x#