##@#########
##|#C----+##
##A#|####|##
##+---B--+##
####|######x
####|######|
####+---D--+