##@---A---+
##########|
######+###C
######-###|
######+---+