##@---+###
######B###
K-----|--A
|#####|##|
|##+--E##|
|##|#####|
+--E--E##C
###|#####|
###+--F--+