@-+##########
##|###+--D--+
##A###|#####|
##+-B----C--+
######|######
######+--E--x