##@---+###
######B###
K-----|--A
|#####|##|
|##+--E##|
|##|#####|
+--E--Ex#C
###|#####|
###+--F--+