##@#########
##|#C----+##
##A#|####|##
##+---B--+-E
#########|#x
#########|#|
#########+-+